NO ./asset/Test/EA.xpm
SO ./asset/Test/SO.xpm
WE ./asset/Test/Untitled.xpm
EA ./asset/Test/WE.xpm

F 255,255,255
C 0,0,0

1111111111111111111111111111111111111111111111111111111111111
1000000000000000000000000000000000000000000000000000000000001
1000000000000000000000000000000000000000000000000000000000001
1000000000000000001111111110000000011111111111111111100000001
1000000000000000001111111100000000011111111111111111100000001
1000000000000000011111111000000000011110000011111111100000001
1000000000000000111111110000000000011000000011111111100000001
1000000000000001111111100000000000010000000011111111100000001
1000000000000011111111000000000000000000000011111111100000001
1000000000000111111110000000000000000000000111111111000000001
1000000000001111111100000000000000000000001111111110000000001
100000000001111111100000000000N000000000011111111100000000001
1000000000111111110000000000000000000000111111110000000000001
1000000001111111100000000000000000000001111111100000000000001
1000000011111111000000000000000000000011111111000000000000001
1000000111111110000000000000000000000111111110000000000000001
1000001111111100000000000000000000001111111110000000000000001
1000011111111111111111111111111110011111111100000000000000001
1000111111111111111111111111111110011111111110000000000010001
1000111111111111111111111111111110011111111110000000000110001
1000000000000000000000000111111110011111111110000000001110001
1000000000000000000000000111111110011111111110000000011110001
1000000000000000000000000111111110011111111111111111111110001
1000000000000000000000000111111110011111111111111111111110001
1000000000000000000000000000000000000000000000000000000000001
1000000000000000000000000000000000000000000000000000000000001
1111111111111111111111111111111111111111111111111111111111111
