NO ./asset/wolftex/pics/greystone.xpm
SO ./asset/wolftex/pics/eagle.xpm
WE ./asset/wolftex/pics/purplestone.xpm
EA ./asset/wolftex/pics/redbrick.xpm






C 225,30,0
F 220,100,0

1111111111111111111111
100W000000000000011
1111111
