NO ./asset/wolftex/pics/greystone.xpm
SO ./asset/wolftex/pics/eagle.xpm
WE ./asset/wolftex/pics/purplestone.xpm
EA ./asset/wolftex/pics/redbrick.xpm

F 220,100,250
C 225,30,222

111111111111111111111111111111111
100000001000000000110000000000001
100000001011000001110000011100001
10000000100100000000000001 100001
111111N11011000001110000011100001
100000000011000001110111111111111
11110111111111011100000010001
11110111111111011101010010001
11000000110101011100000000001
10000000000000001100000010001
10000000000000001101010010001
1100000111010101111101111000111
11110111 1110101 101111010001
11111111 1111111 111111111111
