NO ./asset/wolftex/pics/greystoneNO.xpm
SO ./asset/wolftex/pics/eagleSO.xpm
WE ./asset/wolftex/pics/purplestoneWE.xpm
EA ./asset/wolftex/pics/redbrickEA.xpm

F 220,100,250
C 225,30,222

111111111111111111111111111111111
100000001000000000110000000000001
100000001011000001110000011100001
10000000100100000000000001 100001
11111101101100000111000001110N011
100000000011000001110111111111111
11110111111111011100000010001
11110111111111011101010010001
11000000110101011100000000001
10000000000000001100000010001
10000000000000001101010010001
1100000111010101111001111000111
11110111 1110101 1111111010001
11111111 1111111 111111111111
