NO ./asset/Test/EA.xpm
SO ./asset/Test/SO.xpm
WE ./asset/Test/Untitled.xpm
EA ./asset/Test/WE.xpm

F 255,255,255
C 0,0,0

111111111111111111111111111111111
100000001000000000110000000000001
100000001011000001110000011100001
10000000100100000000000001 100001
111111011011000001110000011100011
100000000011000001110111111111111
11110111111111011100000010001
11110111111111011101010010001
11000000110101011100000000001
10000000000000001100000010001
1000000000000000110101001N001
1100000111010101111001111000111
11110111 1110101 1111111010001
11111111 1111111 111111111111
