NO ./asset/Test/EA.xpm
SO ./asset/Test/SO.xpm
WE ./asset/Test/Untitled.xpm
EA ./asset/Test/WE.xpm

F 255,255,255
C 0,0,0


111111111111111111111111111111111111111111111111111111111111111111111111111111
111111111111111100000000001111111000000000000000000000011111111111111111111111
11111111111111100000S000011111110000000000000000000000011111111111111111111111
111111111111110000000000011111100000000001111111000000111111111111111111111111
111111111111100000000000111111000000000011111110000001111111111111111111111111
111111111111100000000000011111000000000011111000000011111000000011111111111111
111111111111110000000000011110000000000111110000000111110000000000111111111111
111111111111111000000000001111000000000011110000000111100000111000001111111111
111111111111110000000000001111100000000001110000001111100000111100000111111111
100000000000000000000000011111111000000111110000000111100000111100000011111111
100000000000000000000000111111111000000011110000000011100000111110000000111111
100000000011111111111111111111111000000011110000000001110000111111000000111111
100000001111111111111111111111110000000111110000000000111000111110000000111111
100000001111111111111111111111111000000011111000000000011100111100000000011111
100000001111111111111111111111111000000011111100000000001110111000000000011111
100000011111100000001111111111111000000011111110000000000111110000000000111111
100000000111000000000111111111111000000011111111000000000011100000000001111111
100000001111000000000011111111100000000001110111111000000000110000000000111111
100000000111000000000001111111000000000000001111111000000001100000000011111111
100000000000000000000000000000000000000000001111111100000000000000000111111111
100000000000000000000000000000000000000000001111111111000000000000001111111111
111111111111111111111111111111111111111111111111111111111111111111111111111111
